 __      __  _____    _____   _______    ____    _____   __     __ 
 \ \    / / |_   _|  / ____| |__   __|  / __ \  |  __ \  \ \   / / 
  \ \  / /    | |   | |         | |    | |  | | | |__) |  \ \_/ /  
   \ \/ /     | |   | |         | |    | |  | | |  _  /    \   /   
    \  /     _| |_  | |____     | |    | |__| | | | \ \     | |    
     \/     |_____|  \_____|    |_|     \____/  |_|  \_\    |_|  